11111
11E01
1P1C1
10001
11111
