1111111
11E0001
1P1C001
10000X1
1111111
