111111111111111111111111111111111111111111
111111110000000000111111110000000011111111
11100000000000000000000000000000XX000C0C01
10001110000000000C000000000111111111111111
1011111111110000X0000000111000000000111111
100001100000001111000000000000000000001111
1000011000000000111111110000000000000C0001
1000C000000000000000000011000000X000000001
100111100000C00000000000000011111100000001
1000E1100000000000000000001100000011000001
111111100000000X0000C00000000000000000C001
10000C000001111111111111110000000000111111
100000000110000000000000001100000111111111
100011100000000CC0000000000000000000000011
10000X0000000000000000000000000X0C00000001
1111111111100000P0000000001111111111111111
111111111111111111111111111111111111111111
